NO ./textures/xpm/north.xpm
SO ./textures/xpm/south.xpm
WE ./textures/xpm/west.xpm
EA ./textures/xpm/east.xpm

F 220,100,0
C 225,30,255

0111111111111
1001000000001
1000011111001
100011E000001
1111111111111