NO ./textures/xpm/north.xpm
SO ./textures/xpm/south.xpm
WE ./textures/xpm/west.xpm
EA ./textures/xpm/east.xpm

F 220,100,0
C 225,30,255

1111111111111111111111111111111111
1000000000000000000000000000000001
1010010100100000101001000000010101
1110010010101010001001000000010101
1N00000000000000000000000000000001
1111111111111111111111111111111111
