NO ./textures/png2/north.png
SO ./textures/png2/south.png
WE ./textures/png2/west.png
EA ./textures/png2/east.png

F 220,100,0
C 225,30,255

1111111111111
1001000000001
1000011111001
100011E000001
1111111011111